1111111111111
10010000C00C1
1111111110P01
10001E0000111
1111111111111