1111111111111
10010000C00C1
1111011110001
1P011E0000111
1111111111111